03 04 00 00 00 00 00 05 06 06 07 06 06 08 00 00 00 00 03 04
00 00 00 01 02 00 00 05 06 06 07 06 06 08 00 00 00 01 02 00
01 02 00 03 04 00 00 05 06 06 07 06 06 08 00 00 00 03 04 00
03 04 00 00 00 00 00 05 06 06 07 06 06 08 00 00 00 00 01 02
00 00 00 01 02 00 00 05 06 06 07 06 06 08 00 00 00 00 03 04
01 02 00 03 04 00 00 05 06 06 07 06 06 08 00 00 00 01 02 00
03 04 00 00 00 00 00 05 06 06 07 06 06 08 00 00 00 03 04 00
00 00 00 01 02 00 00 05 06 06 07 06 06 08 00 00 00 00 01 02
01 02 00 03 04 00 00 05 06 06 07 06 06 08 00 00 00 00 03 04
03 04 00 00 00 00 00 05 06 06 07 06 06 08 00 00 00 01 02 00
00 00 00 01 02 00 00 05 06 06 07 06 06 08 00 00 00 03 04 00
01 02 00 03 04 00 00 05 06 06 07 06 06 08 00 00 00 00 01 02
03 04 00 00 00 00 00 05 06 06 07 06 06 08 00 00 00 00 03 04
00 00 00 01 02 00 00 05 06 06 07 06 06 08 00 00 00 00 00 00
01 02 00 03 04 00 00 05 06 06 07 06 06 08 00 00 00 00 01 02




