03 03 03 03 03 03 03 03 03 03 03 03 03 03 03 03 03 03 03 03 03 03 03 03 03 03 03 03 03 03 03 03 03 03 03 03 03 03 03 03 
03 03 03 03 03 03 03 03 03 03 03 03 03 03 03 03 03 03 03 03 03 03 03 03 03 03 03 03 03 03 03 03 03 03 03 03 03 03 03 03 
03 03 07 08 01 01 07 08 01 01 01 01 01 07 08 01 01 07 08 03 03 03 07 08 01 01 01 07 08 01 01 01 07 08 01 01 07 08 03 03 
03 03 09 10 01 01 09 10 01 01 01 01 01 09 10 01 01 09 10 03 03 03 09 10 01 01 01 09 10 01 01 01 09 10 01 01 09 10 03 03 
03 03 01 01 01 01 01 01 01 01 01 01 01 01 01 01 01 01 01 03 03 03 01 01 01 01 01 01 01 01 01 01 01 01 01 01 01 01 03 03 
03 03 01 01 01 01 01 22 01 01 01 01 01 01 01 01 01 01 01 03 03 03 01 01 01 01 01 01 01 01 01 01 01 01 01 01 01 01 03 03 
03 03 07 08 01 01 01 01 23 01 01 01 01 01 01 01 01 07 08 03 03 03 07 08 01 01 01 17 01 01 01 01 01 01 01 01 07 08 03 03 
03 03 09 10 01 01 01 01 01 01 01 01 01 01 01 01 01 09 10 03 03 03 09 10 01 01 01 01 01 01 01 01 01 18 01 01 09 10 03 03 
03 03 01 01 01 01 01 01 01 01 01 01 01 01 01 01 01 01 01 03 03 03 01 01 01 01 01 01 01 02 02 02 01 01 01 01 01 01 03 03 
03 03 01 01 01 01 01 01 01 01 01 01 01 01 01 01 01 01 01 03 03 03 01 01 01 01 01 01 01 02 06 02 01 01 01 01 01 01 03 03 
03 03 01 01 01 01 01 01 01 01 01 01 01 01 16 01 01 01 01 03 03 03 01 01 01 01 01 01 01 02 02 02 01 01 01 01 01 01 03 03 
03 03 07 08 01 01 01 01 01 01 01 01 01 01 01 01 01 07 08 03 03 03 07 08 01 01 01 01 01 01 01 01 11 12 01 01 07 08 03 03 
03 03 09 10 01 01 01 01 01 01 11 12 01 01 01 01 01 09 10 03 03 03 09 10 01 01 11 12 01 01 01 01 13 14 01 01 09 10 03 03 
03 03 01 01 01 01 15 01 01 01 13 14 01 01 01 01 01 01 01 03 03 03 01 01 01 01 13 14 01 01 01 01 01 01 01 01 01 01 03 03 
03 03 01 01 01 01 01 01 01 01 01 01 01 01 01 01 01 01 01 03 03 03 01 01 01 01 01 01 01 01 01 01 01 01 01 01 01 01 03 03 
03 03 01 01 01 01 01 01 01 01 01 01 01 01 01 01 01 07 08 03 03 03 07 08 01 01 01 01 01 01 01 01 01 01 01 01 01 01 03 03 
03 03 07 08 01 01 01 07 08 01 01 01 07 08 01 01 01 09 10 03 03 03 09 10 01 01 01 07 08 01 01 01 07 08 01 01 07 08 03 03 
03 03 09 10 01 01 01 09 10 01 01 01 09 10 01 01 01 06 03 03 03 03 03 06 01 01 01 09 10 01 01 01 09 10 01 01 09 10 03 03 
03 03 03 03 25 26 03 03 03 25 26 03 03 03 03 03 03 03 03 02 02 02 03 03 03 03 03 03 03 25 26 03 03 03 25 26 03 03 03 03 
03 03 03 03 03 03 03 03 03 03 03 03 03 03 03 03 03 03 03 02 02 02 03 03 03 03 03 03 03 03 03 03 03 03 03 03 03 03 03 03 
03 03 03 03 03 03 03 03 03 03 03 03 03 03 03 03 03 03 03 02 02 02 03 03 03 03 03 03 03 03 03 03 03 03 03 03 03 03 03 03 
03 03 07 08 01 01 01 07 08 01 01 01 07 08 01 01 01 06 03 03 03 03 03 06 01 01 01 07 08 01 01 01 07 08 01 01 07 08 03 03 
03 03 09 10 01 01 01 09 10 01 01 01 09 10 01 01 01 07 08 03 03 03 07 08 01 01 01 09 10 01 01 01 09 10 01 01 09 10 03 03 
03 03 01 01 01 01 01 01 01 01 01 01 01 01 01 01 01 09 10 03 03 03 09 10 01 01 01 01 01 01 01 01 01 01 01 01 01 01 03 03 
03 03 01 01 01 01 01 01 01 01 01 01 01 01 01 01 01 01 01 03 03 03 01 01 01 01 01 01 01 01 01 01 01 01 01 01 01 01 03 03 
03 03 01 01 01 01 01 01 01 01 01 01 01 01 01 01 01 01 01 03 03 03 01 01 01 01 01 01 01 01 21 01 01 01 01 01 01 01 03 03 
03 03 07 08 01 01 01 19 01 01 01 11 12 01 01 01 01 07 08 03 03 03 07 08 01 01 01 01 01 01 01 01 01 01 01 01 07 08 03 03 
03 03 09 10 01 01 01 01 01 01 01 13 14 01 01 01 01 09 10 03 03 03 09 10 01 01 11 12 03 03 03 03 11 12 01 01 09 10 03 03 
03 03 01 01 01 01 01 01 01 01 01 01 01 01 01 01 01 01 01 03 03 03 01 01 01 01 13 14 03 06 06 03 13 14 01 01 01 01 03 03 
03 03 01 01 01 01 01 01 01 01 01 01 01 01 01 01 01 01 01 03 03 03 01 01 01 01 01 01 03 06 06 03 01 01 01 01 01 01 03 03 
03 03 01 01 01 01 11 12 01 01 01 01 01 01 01 01 01 01 01 03 03 03 01 01 01 01 01 01 05 05 05 05 01 01 01 01 01 01 03 03 
03 03 07 08 01 01 13 14 01 01 01 01 01 01 01 01 01 07 08 03 03 03 07 08 01 01 01 01 01 01 01 01 01 01 01 01 07 08 03 03 
03 03 09 10 01 01 01 01 01 01 20 01 01 01 01 01 01 09 10 03 03 03 09 10 01 01 01 01 22 01 01 01 01 01 01 01 09 10 03 03 
03 03 01 01 01 01 01 01 01 01 01 01 01 01 01 01 01 01 01 03 03 03 01 01 01 01 01 24 01 01 01 01 01 01 01 01 01 01 03 03 
03 03 01 01 01 01 01 01 01 01 01 01 01 01 01 01 01 01 01 03 03 03 01 01 01 01 01 01 01 01 01 01 01 01 01 01 01 01 03 03 
03 03 01 01 01 01 01 01 01 01 01 01 01 01 01 01 01 01 01 03 03 03 01 01 01 01 01 01 01 01 01 01 01 01 01 01 01 01 03 03 
03 03 07 08 01 01 07 08 01 01 01 01 07 08 01 01 01 07 08 03 03 03 07 08 01 01 01 07 08 01 01 01 07 08 01 01 07 08 03 03 
03 03 09 10 01 01 09 10 01 01 01 01 09 10 01 01 01 09 10 03 03 03 09 10 01 01 01 09 10 01 01 01 09 10 01 01 09 10 03 03 
03 03 03 03 25 26 03 03 03 25 26 03 03 03 25 26 03 03 03 03 03 03 03 03 25 26 03 03 03 25 26 03 03 03 25 26 03 03 03 03 
03 03 03 03 03 03 03 03 03 03 03 03 03 03 03 03 03 03 03 03 03 03 03 03 03 03 03 03 03 03 03 03 03 03 03 03 03 03 03 03
